PokerStars Hand #179820627532:  Hold'em No Limit ($0.01/$0.02 USD) - 2017/12/20 21:28:36 WET [2017/12/20 16:28:36 ET]
Table 'Timandra' 6-max Seat #3 is the button
Seat 1: Fan23554 ($1.97 in chips) 
Seat 2: Serebanius ($2.12 in chips) 
Seat 3: IvamMieor ($0.63 in chips) 
Seat 4: rorrrr ($1.98 in chips) 
Seat 5: Chertan53 ($2.13 in chips) 
rorrrr: posts small blind $0.01
Chertan53: posts big blind $0.02
caridwen: sits out 
*** HOLE CARDS ***
Dealt to rorrrr [6s Th]
Fan23554: folds 
Serebanius: folds 
IvamMieor: calls $0.02
rorrrr: calls $0.01
Chertan53: checks 
*** FLOP *** [Ks Ah Jh]
rorrrr: checks 
Chertan53: checks 
IvamMieor: checks 
*** TURN *** [Ks Ah Jh] [5c]
rorrrr: checks 
Chertan53: checks 
IvamMieor: checks 
*** RIVER *** [Ks Ah Jh 5c] [9d]
rorrrr: checks 
Chertan53: checks 
IvamMieor: bets $0.02
rorrrr: folds 
Chertan53: folds 
Uncalled bet ($0.02) returned to IvamMieor
IvamMieor collected $0.06 from pot
IvamMieor: doesn't show hand 
*** SUMMARY ***
Total pot $0.06 | Rake $0 
Board [Ks Ah Jh 5c 9d]
Seat 1: Fan23554 folded before Flop (didn't bet)
Seat 2: Serebanius folded before Flop (didn't bet)
Seat 3: IvamMieor (button) collected ($0.06)
Seat 4: rorrrr (small blind) folded on the River
Seat 5: Chertan53 (big blind) folded on the River



PokerStars Hand #179820672149:  Hold'em No Limit ($0.01/$0.02 USD) - 2017/12/20 21:29:32 WET [2017/12/20 16:29:32 ET]
Table 'Timandra' 6-max Seat #4 is the button
Seat 1: Fan23554 ($1.97 in chips) 
Seat 2: Serebanius ($2.12 in chips) 
Seat 3: IvamMieor ($0.67 in chips) 
Seat 4: rorrrr ($1.96 in chips) 
Seat 5: Chertan53 ($2.11 in chips) 
Seat 6: caridwen ($3.88 in chips) 
Chertan53: posts small blind $0.01
caridwen: posts big blind $0.02
*** HOLE CARDS ***
Dealt to rorrrr [5c Ah]
Fan23554: raises $0.04 to $0.06
Serebanius: folds 
IvamMieor: folds 
rorrrr: folds 
Chertan53: folds 
caridwen: folds 
Uncalled bet ($0.04) returned to Fan23554
Fan23554 collected $0.05 from pot
Fan23554: doesn't show hand 
*** SUMMARY ***
Total pot $0.05 | Rake $0 
Seat 1: Fan23554 collected ($0.05)
Seat 2: Serebanius folded before Flop (didn't bet)
Seat 3: IvamMieor folded before Flop (didn't bet)
Seat 4: rorrrr (button) folded before Flop (didn't bet)
Seat 5: Chertan53 (small blind) folded before Flop
Seat 6: caridwen (big blind) folded before Flop



PokerStars Hand #179820694149:  Hold'em No Limit ($0.01/$0.02 USD) - 2017/12/20 21:30:00 WET [2017/12/20 16:30:00 ET]
Table 'Timandra' 6-max Seat #5 is the button
Seat 1: Fan23554 ($2 in chips) 
Seat 2: Serebanius ($2.12 in chips) 
Seat 3: IvamMieor ($0.67 in chips) 
Seat 4: rorrrr ($1.96 in chips) 
Seat 5: Chertan53 ($2.10 in chips) 
Seat 6: caridwen ($3.86 in chips) 
caridwen: posts small blind $0.01
Fan23554: posts big blind $0.02
*** HOLE CARDS ***
Dealt to rorrrr [Jc 9h]
Serebanius: folds 
IvamMieor: calls $0.02
rorrrr: folds 
Chertan53 has timed out
Chertan53: folds 
caridwen: folds 
Fan23554: checks 
*** FLOP *** [6s Jd Kh]
Fan23554: checks 
IvamMieor: checks 
*** TURN *** [6s Jd Kh] [3s]
Fan23554: checks 
IvamMieor: checks 
*** RIVER *** [6s Jd Kh 3s] [4s]
Fan23554: bets $0.04
IvamMieor: calls $0.04
*** SHOW DOWN ***
Fan23554: shows [4h Qc] (a pair of Fours)
IvamMieor: shows [4d As] (a pair of Fours - Ace kicker)
IvamMieor collected $0.13 from pot
*** SUMMARY ***
Total pot $0.13 | Rake $0 
Board [6s Jd Kh 3s 4s]
Seat 1: Fan23554 (big blind) showed [4h Qc] and lost with a pair of Fours
Seat 2: Serebanius folded before Flop (didn't bet)
Seat 3: IvamMieor showed [4d As] and won ($0.13) with a pair of Fours
Seat 4: rorrrr folded before Flop (didn't bet)
Seat 5: Chertan53 (button) folded before Flop (didn't bet)
Seat 6: caridwen (small blind) folded before Flop



PokerStars Hand #179820735747:  Hold'em No Limit ($0.01/$0.02 USD) - 2017/12/20 21:30:53 WET [2017/12/20 16:30:53 ET]
Table 'Timandra' 6-max Seat #6 is the button
Seat 1: Fan23554 ($1.94 in chips) 
Seat 2: Serebanius ($2.12 in chips) 
Seat 3: IvamMieor ($0.74 in chips) 
Seat 4: rorrrr ($1.96 in chips) 
Seat 6: caridwen ($3.85 in chips) 
Fan23554: posts small blind $0.01
Serebanius: posts big blind $0.02
*** HOLE CARDS ***
Dealt to rorrrr [Ad Tc]
IvamMieor: folds 
rorrrr: raises $0.04 to $0.06
caridwen: folds 
Fan23554: folds 
Serebanius: raises $0.12 to $0.18
rorrrr: folds 
Uncalled bet ($0.12) returned to Serebanius
Serebanius collected $0.13 from pot
Serebanius: doesn't show hand 
*** SUMMARY ***
Total pot $0.13 | Rake $0 
Seat 1: Fan23554 (small blind) folded before Flop
Seat 2: Serebanius (big blind) collected ($0.13)
Seat 3: IvamMieor folded before Flop (didn't bet)
Seat 4: rorrrr folded before Flop
Seat 6: caridwen (button) folded before Flop (didn't bet)



PokerStars Hand #179820757029:  Hold'em No Limit ($0.01/$0.02 USD) - 2017/12/20 21:31:20 WET [2017/12/20 16:31:20 ET]
Table 'Timandra' 6-max Seat #1 is the button
Seat 1: Fan23554 ($1.93 in chips) 
Seat 2: Serebanius ($2.19 in chips) 
Seat 3: IvamMieor ($0.74 in chips) 
Seat 4: rorrrr ($1.90 in chips) 
Seat 5: Chertan53 ($2.10 in chips) 
Seat 6: caridwen ($3.85 in chips) 
Serebanius: posts small blind $0.01
IvamMieor: posts big blind $0.02
*** HOLE CARDS ***
Dealt to rorrrr [3d Qs]
rorrrr: folds 
Chertan53: folds 
caridwen: folds 
Fan23554: raises $0.04 to $0.06
Serebanius: folds 
IvamMieor: folds 
Uncalled bet ($0.04) returned to Fan23554
Fan23554 collected $0.05 from pot
Fan23554: doesn't show hand 
*** SUMMARY ***
Total pot $0.05 | Rake $0 
Seat 1: Fan23554 (button) collected ($0.05)
Seat 2: Serebanius (small blind) folded before Flop
Seat 3: IvamMieor (big blind) folded before Flop
Seat 4: rorrrr folded before Flop (didn't bet)
Seat 5: Chertan53 folded before Flop (didn't bet)
Seat 6: caridwen folded before Flop (didn't bet)



PokerStars Hand #179821245858:  Hold'em No Limit ($0.01/$0.02 USD) - 2017/12/20 21:41:47 WET [2017/12/20 16:41:47 ET]
Table 'Timandra' 6-max Seat #2 is the button
Seat 1: Fan23554 ($3.32 in chips) 
Seat 2: Serebanius ($2.08 in chips) 
Seat 3: IvamMieor ($0.98 in chips) 
Seat 4: rorrrr ($1.90 in chips) 
Seat 5: Chertan53 ($2.12 in chips) 
Seat 6: caridwen ($3.88 in chips) 
IvamMieor: posts small blind $0.01
rorrrr: posts big blind $0.02
*** HOLE CARDS ***
Dealt to rorrrr [6d 6h]
Chertan53: folds 
caridwen: folds 
Fan23554: raises $0.04 to $0.06
Serebanius: folds 
IvamMieor: folds 
rorrrr: calls $0.04
*** FLOP *** [5s Ts Tc]
rorrrr: checks 
Fan23554: bets $0.06
rorrrr: calls $0.06
*** TURN *** [5s Ts Tc] [8d]
rorrrr: checks 
Fan23554: checks 
*** RIVER *** [5s Ts Tc 8d] [8c]
rorrrr: checks 
Fan23554: checks 
*** SHOW DOWN ***
rorrrr: shows [6d 6h] (two pair, Tens and Eights)
Fan23554: shows [7h 7s] (two pair, Tens and Eights - Seven kicker)
Fan23554 collected $0.24 from pot
*** SUMMARY ***
Total pot $0.25 | Rake $0.01 
Board [5s Ts Tc 8d 8c]
Seat 1: Fan23554 showed [7h 7s] and won ($0.24) with two pair, Tens and Eights
Seat 2: Serebanius (button) folded before Flop (didn't bet)
Seat 3: IvamMieor (small blind) folded before Flop
Seat 4: rorrrr (big blind) showed [6d 6h] and lost with two pair, Tens and Eights
Seat 5: Chertan53 folded before Flop (didn't bet)
Seat 6: caridwen folded before Flop (didn't bet)



PokerStars Hand #179821292463:  Hold'em No Limit ($0.01/$0.02 USD) - 2017/12/20 21:42:47 WET [2017/12/20 16:42:47 ET]
Table 'Timandra' 6-max Seat #3 is the button
Seat 1: Fan23554 ($3.44 in chips) 
Seat 2: Serebanius ($2.08 in chips) 
Seat 3: IvamMieor ($0.97 in chips) 
Seat 4: rorrrr ($1.78 in chips) 
Seat 5: Chertan53 ($2.12 in chips) 
Seat 6: caridwen ($3.88 in chips) 
rorrrr: posts small blind $0.01
Chertan53: posts big blind $0.02
*** HOLE CARDS ***
Dealt to rorrrr [3h 8c]
caridwen: folds 
Fan23554: folds 
Serebanius: folds 
IvamMieor: calls $0.02
rorrrr: folds 
Chertan53: checks 
*** FLOP *** [9c As Ah]
Chertan53: checks 
IvamMieor: bets $0.02
Chertan53: folds 
Uncalled bet ($0.02) returned to IvamMieor
IvamMieor collected $0.05 from pot
IvamMieor: doesn't show hand 
*** SUMMARY ***
Total pot $0.05 | Rake $0 
Board [9c As Ah]
Seat 1: Fan23554 folded before Flop (didn't bet)
Seat 2: Serebanius folded before Flop (didn't bet)
Seat 3: IvamMieor (button) collected ($0.05)
Seat 4: rorrrr (small blind) folded before Flop
Seat 5: Chertan53 (big blind) folded on the Flop
Seat 6: caridwen folded before Flop (didn't bet)



